1 13 31
###############################
#p      # *  1 * 2    * * *   #
# #    #### #* *    # f*#*#   #
#   *      **  *  1   * 2 * * #
#   *   # #*  # # #*# # # #   #
#f         x **  *  *   1     #
# # s #   b   # #     #*# x # #
#   *      *  *      *        #
# #   # #*# # # #*#x# # # # # #
#*     *  *       *           #
# #*       #    #*# # #   # # #
#           *   *  *          #
###############################

