1 13 31
###############################
#p      o    1 * 2    * * *   #
# #    *# # #* *# # # #*#*#   #
#  x*      **  *  1   * 2 * * #
# # # #   #*  # # #*# # # #   #
#f         x **  *  *   1     #
# # # #   #   # #     #*# # # #
#   *      *  *      *        #
# #   # #*# # # #*#*# # # # # #
#*     *  *       *           #
# #*      # # # #*# # #   # # #
#           *   *  *          #
###############################

