1 13 31
###############################
#   d          m           d   #
#                   d         #
#   d                    d    #
#         d       d           #
#            d            d   #
#                             #
#   d               d         #
#                             #
# d                       d   #
#                             #
###############################

