1 13 31
###############################
#p      x *  1 * 2    * * *   #
# #    #### #* *    # f*#*#   #
#   *      **  *  1   * 2 * * #
#   *   # #*  # # #*# # # #   #
#f        d                   #
# # s #   b   # #     #*# x # #
#   *      *  *      *        #
# #   # #*# # # #*#x# # # # # #
#*     *  *       *           #
# #*       #    #*# # #   # # #
#           *   *  *          #
###############################

