1 13 31
###############################
#p      o    b * s    * * *   #
# #    *# # #* *# # # #*#*#   #
#  x       h*  *  1   * 2 * * #
# # # #   #*  # # #*# # # #   #
#fk         x **  *  *   1     #
# # # #   #   # #     #*# # # #
#   *      *  *      *        #
# #   # #*# # # #*#*# # # # # #
#*     *  *       *           #
# #*      # # # #*# # #   # # #
#           *   *  *          #
###############################

